"filename", "language", "JSON", "JavaScript", "TypeScript", "comment", "blank", "total"
"c:\code\simplestars\functions\index.js", "JavaScript", 0, 194, 0, 12, 1, 207
"c:\code\simplestars\functions\index.ts", "TypeScript", 0, 0, 93, 21, 38, 152
"c:\code\simplestars\functions\package-lock.json", "JSON", 1911, 0, 0, 0, 1, 1912
"c:\code\simplestars\functions\package.json", "JSON", 23, 0, 0, 0, 1, 24
"c:\code\simplestars\functions\src\buildings\fBuildingRules.js", "JavaScript", 0, 195, 0, 1, 1, 197
"c:\code\simplestars\functions\src\buildings\fBuildingRules.ts", "TypeScript", 0, 0, 163, 1, 28, 192
"c:\code\simplestars\functions\src\data\fDataBuildings.js", "JavaScript", 0, 310, 0, 6, 1, 317
"c:\code\simplestars\functions\src\data\fDataBuildings.ts", "TypeScript", 0, 0, 307, 6, 4, 317
"c:\code\simplestars\functions\src\data\fDataShips.js", "JavaScript", 0, 670, 0, 33, 1, 704
"c:\code\simplestars\functions\src\data\fDataShips.ts", "TypeScript", 0, 0, 647, 34, 27, 708
"c:\code\simplestars\functions\src\data\fDataTechnology.js", "JavaScript", 0, 543, 0, 2, 1, 546
"c:\code\simplestars\functions\src\data\fDataTechnology.ts", "TypeScript", 0, 0, 539, 2, 16, 557
"c:\code\simplestars\functions\src\functionConfigs.js", "JavaScript", 0, 5, 0, 0, 1, 6
"c:\code\simplestars\functions\src\functionConfigs.ts", "TypeScript", 0, 0, 2, 0, 5, 7
"c:\code\simplestars\functions\src\models\fBuildings.js", "JavaScript", 0, 2, 0, 0, 1, 3
"c:\code\simplestars\functions\src\models\fBuildings.ts", "TypeScript", 0, 0, 25, 0, 3, 28
"c:\code\simplestars\functions\src\models\fCommands.js", "JavaScript", 0, 15, 0, 0, 1, 16
"c:\code\simplestars\functions\src\models\fCommands.ts", "TypeScript", 0, 0, 45, 0, 8, 53
"c:\code\simplestars\functions\src\models\fCommunication.js", "JavaScript", 0, 2, 0, 0, 1, 3
"c:\code\simplestars\functions\src\models\fCommunication.ts", "TypeScript", 0, 0, 16, 0, 12, 28
"c:\code\simplestars\functions\src\models\fModels.js", "JavaScript", 0, 41, 0, 0, 1, 42
"c:\code\simplestars\functions\src\models\fModels.ts", "TypeScript", 0, 0, 144, 0, 23, 167
"c:\code\simplestars\functions\src\models\fReport.js", "JavaScript", 0, 11, 0, 0, 1, 12
"c:\code\simplestars\functions\src\models\fReport.ts", "TypeScript", 0, 0, 64, 0, 21, 85
"c:\code\simplestars\functions\src\models\fUnits.js", "JavaScript", 0, 32, 0, 0, 1, 33
"c:\code\simplestars\functions\src\models\fUnits.ts", "TypeScript", 0, 0, 70, 0, 12, 82
"c:\code\simplestars\functions\src\tech\fBusinessTech.js", "JavaScript", 0, 139, 0, 0, 1, 140
"c:\code\simplestars\functions\src\tech\fBusinessTech.ts", "TypeScript", 0, 0, 110, 0, 21, 131
"c:\code\simplestars\functions\src\tech\fInvasionTech.js", "JavaScript", 0, 35, 0, 0, 1, 36
"c:\code\simplestars\functions\src\tech\fInvasionTech.ts", "TypeScript", 0, 0, 22, 0, 8, 30
"c:\code\simplestars\functions\src\tech\fShipTech.js", "JavaScript", 0, 94, 0, 7, 1, 102
"c:\code\simplestars\functions\src\tech\fShipTech.ts", "TypeScript", 0, 0, 73, 7, 24, 104
"c:\code\simplestars\functions\src\tech\fTechTools.js", "JavaScript", 0, 7, 0, 0, 1, 8
"c:\code\simplestars\functions\src\tech\fTechTools.ts", "TypeScript", 0, 0, 5, 0, 2, 7
"c:\code\simplestars\functions\src\turnProcessor.js", "JavaScript", 0, 1120, 0, 64, 1, 1185
"c:\code\simplestars\functions\src\turnProcessor.ts", "TypeScript", 0, 0, 961, 69, 193, 1223
"c:\code\simplestars\functions\src\utils\fBuildingUtils.js", "JavaScript", 0, 80, 0, 0, 1, 81
"c:\code\simplestars\functions\src\utils\fBuildingUtils.ts", "TypeScript", 0, 0, 67, 0, 14, 81
"c:\code\simplestars\functions\src\utils\fFactionUtils.js", "JavaScript", 0, 220, 0, 40, 1, 261
"c:\code\simplestars\functions\src\utils\fFactionUtils.ts", "TypeScript", 0, 0, 229, 40, 51, 320
"c:\code\simplestars\functions\src\utils\fGeneralUtils.js", "JavaScript", 0, 123, 0, 0, 1, 124
"c:\code\simplestars\functions\src\utils\fGeneralUtils.ts", "TypeScript", 0, 0, 39, 0, 4, 43
"c:\code\simplestars\functions\src\utils\fLocationUtils.js", "JavaScript", 0, 7, 0, 0, 1, 8
"c:\code\simplestars\functions\src\utils\fLocationUtils.ts", "TypeScript", 0, 0, 4, 0, 5, 9
"c:\code\simplestars\functions\src\utils\fMathUtils.js", "JavaScript", 0, 62, 0, 0, 1, 63
"c:\code\simplestars\functions\src\utils\fMathUtils.ts", "TypeScript", 0, 0, 48, 0, 28, 76
"c:\code\simplestars\functions\src\utils\fRandUtils.js", "JavaScript", 0, 112, 0, 45, 1, 158
"c:\code\simplestars\functions\src\utils\fRandUtils.ts", "TypeScript", 0, 0, 89, 45, 24, 158
"c:\code\simplestars\functions\src\utils\fSystemUtils.js", "JavaScript", 0, 113, 0, 3, 1, 117
"c:\code\simplestars\functions\src\utils\fSystemUtils.ts", "TypeScript", 0, 0, 129, 3, 17, 149
"c:\code\simplestars\functions\src\utils\fTechUtils.js", "JavaScript", 0, 72, 0, 5, 1, 78
"c:\code\simplestars\functions\src\utils\fTechUtils.ts", "TypeScript", 0, 0, 53, 5, 14, 72
"c:\code\simplestars\functions\src\utils\fUnitUtils.js", "JavaScript", 0, 192, 0, 6, 1, 199
"c:\code\simplestars\functions\src\utils\fUnitUtils.ts", "TypeScript", 0, 0, 164, 6, 36, 206
"c:\code\simplestars\functions\src\utils\fWeaponUtils.js", "JavaScript", 0, 11, 0, 0, 1, 12
"c:\code\simplestars\functions\src\utils\fWeaponUtils.ts", "TypeScript", 0, 0, 7, 0, 4, 11
"c:\code\simplestars\functions\tsconfig.json", "JSON", 16, 0, 0, 46, 8, 70
"Total", "-", 1950, 4407, 4115, 509, 679, 11660